#######---##############---##############---##############---#######
#-------##-------#-------##-------#-------##-------#-------##-------
#---^--------^---#---^--------^---#---^--------^---B----------^-----
B----------^-----B----------^-----B----------^-----#-------##-------
B----------^-----B----------^-----B----------^-----#-------##-------
B----------^-----B----------^-----B----------^-----#-------##-------
##------------#--##------------#--##------------#--#---^--------^---
##------------#--##------------#--##------------#--#---^--------^---
F-OOO-------OOO-FF-OOO-------OOO-FF-OOO-------OOO-F##-----&----###--
##-----&----###--##-----&----###--##-----&----###--F--------------f-
F--------------f-F--------------f-F--------------f-F--------------f-
F-OOO-------OOO-FF-OOO-------OOO-FF-OOO-------OOO-F##-----&----###--
@---------------#---^--------^---#---^--------^---#---^--------^---P
####################################################################